█████████
█       █
█       █
█       █
█       █
█       █
█       █
█      ◯█
█████████
